{
    "monster speed": 4
    "field":
        . . . . . . . . . #
        . . . # . M . R . .
        . . . # . . . . . .
        . . M # # . . . . .
        . . D . . . . . u .
        . . . . . . . L . .
        . . . . . M . . . B
    "prizes":
        . . . . . . . . . .
        . . . . . . . . . .
        . . . 1 . . . . . .
        . . . . . . . . . .
        . . . . . . . . 3 .
        . . . . . . . . 3 1
        . 2 . . . . . . 2 .
}
