{
    "monster speed": 100
    "field":
        . . . . . . . . . #
        . . . # . M . R . .
        . . . # . . . . . .
        . . M # # . . . . .
        . . D . . . . . u .
        . . . . . . . L B .
        . * . * * M . . . .
    "prizes":
        . . . . . . . . . .
        . . . . . . . . . .
        . . . 1 . . . . . .
        . . . . . . . . . .
        . . . . . . . . 3 .
        . . . . . . . . . .
        . 2 . . . . . . . .
}
