{
    "monster speed": 100
    "field":
        # # # # # # *
        # B . . . M *
        # . * . U * #
        # D . # . . #
        # . r . d * #
        # . M . . . #
        # # # # # # #
    "prizes":
        . . . . . . .
        . . . . . . .
        . . 2 . . . .
        . . . . . . .
        . . 1 . 3 2 .
        . . . . . . .
        . . . . . . .
}
