{
    "monster speed": 100
    "field":
        . . . . . . . . . #
        . . . # . M . R . .
        . . . # . . . . . .
        . . M # # . . . . .
        . . D . . . . . u .
        . . . . . . . L . .
        . * . * * M . . . B
    "prizes":
        . . . . . . . . . .
        . . . . . . . . . .
        . . . 1 . . . . . .
        . . . . . . . . . .
        . . . . . . . . 3 .
        . . . . . . . . . .
        . 2 . . . . . . . .
}
